11111111111111111111
1P00000C000000A00001
111110000A0010011001
1C00000C001011000001
1A00A00A10A000000001
1000000010000A000001
1C111111101000100001
1000C0000000111E0001
1000E000A000C0100001
11111111111111111111
