11111111111
1P00100C001
1100000A001
1C00000C001
1C110111101
100000A0001
1000E0000E1
11111111111
