11111111111
1P000000001
11111000001
10000000001
10111111101
10000000001
100000000E1
11111111111
