11111111111
1P00000C001
11111000001
1C00000C001
1C111111101
1000C000001
10000000001
11111111111
