11111111111
1h00000C001
11111000001
1C00000C001
1C111111101
1000C000001
1000E0000E1
11111111111
