11111111111
1P000000001
11111000001
1C0000000A1
1C111111101
10000000001
100000A0001
1000E0000E1
11111111111
