11111111111
1P00100C001
11000000001
1C00000C001
1C110111101
10000000001
1000E0000E1
10C00000001
1000C000001
1000C000001
10C00000001
11111111111